# #######################################
#     #         #   #     #   #   #     #
# # ######### # # ### ##### ### # ##### #
# #   #       #       #     #   #   #   #
### ### ##### # ##### # # # # ####### ###
#         #   #   # #   # # #   #     # #
# ##### # ##### # # # ### # ### ##### # #
#   #   #   # # # #     # # # # # # #   #
####### ### # ########### ### # # # # ###
# #       #   # # #     # #     #   #   #
# # # ### ##### # ##### # # # # ### ### #
#   # #   #       #     #   # #   #     #
# ### # # ####### ##### ### ### # # # ###
# # # # #   #               #   # # #   #
# # ### ### ##### # # ######### ##### # #
#   #     #   # # # #   #   # # #   # # #
# # # ##### # # # ####### ### # # ##### #
# #       # # #     #     #         #   #
### ######### ### ####### # ##### ##### #
#   # #             #         # # #     #
# ### ####### ##### ### # # ### ### # # #
#         #   # #   #   # #   #   # # # #
### ######### # ### ######### # ### # ###
#       #   #   # #   #             #   #
# ####### # # ### ### ##### ####### # # #
# #     # # # # #   #     # #       # # #
# # ##### ##### ### ### ####### ##### ###
#   #   # #       #   #     #   #       #
# ### # # ### # ##### ### ####### # ### #
# # # # # #   #     #   # #   #   #   # #
# # # ### # ##### ### ### # ##### ##### #
#       #   #                 # # #   # #
# # # # ### ### # ##### ### # # # # # ###
# # # # # # #   #   # # # # # #     #   #
# # ### # # # ### ### ### ### # ### # # #
# # #     # # #   # # # #         # # # #
##### ##### ##### # # # ### ##### # ### #
#   #       #         #   # # #       # #
# ### ### ##### ##### # ### # # # ### # #
#       # #         #     # #   #   #    
#########################################