# ###################
#         # #     # #
# ##### # # # ##### #
# # #   #       #   #
# # # ### ### # ### #
#         # # #     #
### ##### # ##### ###
#   # # #   #   #   #
# ### # # ### # ## ##
#     #     # #     #
##### ### ####### # #
#             #   # #
# # ##### # ### #####
# # # # # #   #   # #
# ### # # ### ### # #
#       #   #   #   #
# # ### # # ##### # #
# #   # # #   # # # #
### # # ##### # ### #
#   # #              
#####################