# ###################################################################################################
# # #     #   #     #     #   #   #   #       #   # # #         #         # #   #   #               #
# # ##### # # ### ####### # # # ### ### # ##### # # # ##### ######### # ### ### # # # ### ##### ### #
#                 #   # #   #     #     # #   # #     #       # # # # #     #   # # # #     # # #   #
# # ### ### # ### # ### ######### # ####### ##### ####### ##### # # ##### # # ### # # ##### # #######
# #   # #   #   # #         #         #       # #       #       # #   #   # #     # # # # # #       #
# # ### # ### # # ### ############### ####### # ### ####### # ### # # # # ####### ##### # # # ##### #
# #   # #   # # #       #                   #     #     #   #   #   #   #   #     #     # #   #   # #
##### ##### ### ### # # ### # ### # ### ##### # ### # # ##### # ####### ##### ##### # # # # # ### # #
# #   #     #     # # # #   #   # # # #   # # # #   # #     # #   #     #           # #   # #   # # #
# # # ### # ##### ##### ##### ##### # # ### # # ### # # ### # # ##### ### ####### ########### ### # #
#   # # # # # #   # #   #   # #   # #   #     #     # #   #   # #   #   #       # #   #   # #   #   #
####### ### # # ### ### ### # # # # # ##### ####### ### # # ####### # # # ### # # # ### ### ##### # #
#   #   #     # #   #       # # # # #     #   #     # # # #   #       #   # # # # #   #         # # #
# # ### ### ##### # # ### # # ### # ####### ### ### # ### ####### # # # # # ####### ### ### ##### # #
# # #           # # # #   #       # #       #   #   #     #   #   # # # #     #       # # # # #   # #
### # ### # # ##### # ####### ### ####### ########### ### # ####### ##### ####### # # # # # # # ### #
#   # #   # # #       # # # # #         #   #         #   # # # # # #       #   # # #   # #       # #
# ####### ### ### # # # # # ######### ### ### # # ####### # # # # ####### ##### ### ### # ### #######
#   #   # #       # #         #             # # #     #   #     # #       #   #       #     #   #   #
### # # ##### ####### # ####### ########### ##### # ### # # # ### # ### ##### # ### ### ######### ###
#   # #   #     # #   # #         #     #         #   # # # #       # # #     # #     # # #     #   #
# # ##### ### # # # # # ### ### # # ### # # ### ####### ### # ##### # ### # # ### # # ### # ####### #
# #     # #   # # # # #   # #   #   #   # #   #       # # # # #         # # # #   # #     # #       #
# # ##### ### # # ### ### ### ##### ### ### ######### # # ### ### ### ####### # # # ####### # # # ###
# # #   # # # # # #   #   # #   #   #       #   # # #           # #       # #   # #   #   #   # #   #
### ### # # ##### # # # # # # ####### ### ##### # # ### ####### ### ##### # # # # ### # # ####### ###
# #         #     # # # #     #   # # #   #     # # #   #     #     # #   # # # # # # # #       #   #
# # ##### # # # # # # ### ### # ### # # # # ##### # ##### ##### ### # ##### # ### # ####### ### # ###
# #   #   # # # #   # #   # #       # # # #       #   #       # #             #   #   # #   #       #
# ### ##### # ####### ##### ### # ### ##### ####### ### ################# ### # ### # # # ###########
#     #   #   # #             # # # #   # #   # #               #   #       # #   # #   #   #   #   #
### # ### # ### ######### ### # # # ### # # # # # ### ### ######### ### ##### ### ### # # # ### # ###
# # # #     #   # #     #   # # #   # # #   # #   #   #   #     #   # #               #   # #     # #
# ### # # # ### # ##### # ####### ### ##### ##### # ####### # ### ### # ####### ### ### ######### # #
#   # # # # # #         # # #       #       # # # #   #   # #     #     # #   #   # #     #     #   #
# # ######### # # # ####### ### # ####### ### # ##### ### # ######### ### ### ### ############# # # #
# #   #   #     # #     # # #   #   #                       #           # # #         #           # #
# ####### ### ##### ##### # # ### ### ##### ### # ### # ### # ########### # ##### ### # # # ### ### #
#   #     # #   #               # #     #   # # # #   # # #         # # #   # #     #   # # #     # #
# ### # ### ### # ### ##### ##### ### ##### # # ### ### # ### # ### # # ### # ##### ### ##### #######
#   # #   #     # # # #   #     #     #     #     #   # #     # # # # #           #   #             #
# ##### # # ####### # # ### ### # ##### ##### ######### ### ##### ### # ############### # # #########
#   # # # # #       #     # # # # # #   #           #     #   #           # #       #   # #     #   #
### # # ##### ##### ### ### # ### # ####### ######### # ### # # ##### ### # ##### ### # ### ### ### #
# #       #     # #     #     #     # #     #       # # #   #     #   # #   #   #     #   #   # #   #
# ### # ### ##### # ### # ######### # ##### ### # # ### ############# # ### # # ####### ### ### # ###
#     # # # # # #     # #         #   #       # # #   # # #           #     # #     #       #   #   #
# # ### # # # # ####### # ####### ############# ### ##### ### ### # ####### ### # ### ##### ##### ###
# # #         # #   # # #       # #             #     #         # #   # # #     #     #     #   #   #
########### ### # # # # ######### ### ##### # ### ### # ### ##### # ### # # ### ### ####### # ### # #
# #     #   #     #   #         #   # # # # # # # #   #   # # #   # #     # # # # #   #     #     # #
# ##### ### # # # ##### ##### ##### # # # ##### ### ### ##### # ######### ### ### ### # ### ##### # #
#   # # #     # # #         # # #   #   # # #   # #         #       #               # # #   #   # # #
# ### # # ############# # ##### # ##### # # ### # # # ### ##### # ### ##### ### ### # # ####### # ###
# # #   # #       # #   #   # #   #     #     #     #   #   #   #   #     # #   #   # #           # #
# # # # # # # # # # ######### # ##### ##### # # # ########### # ######### ##### ####### # ##### ### #
#     # #   # # #     # # #       #     #   #   #     #   # # # # #     # #       #     #     #   # #
# ### # ### ### ##### # # # # # ##### ####### ### ### # ### # ### # ##### ##### ### ##### ####### # #
# #   #       # #   # #   # # # #   # #   #     # #   # #     #       #   #         # # #   # #   # #
####### ### ##### ### ### # ### # ### # # # # ######### # ### # # ### ########### ### # # ### ### # #
#         # #       # #   # # #   # # # #   # #   #   #   # #   #   # #   #   # #     # # #   #   # #
##### ### ######### # # ##### ##### # ### ##### ### ### # # # ########### # ### ##### # # # # ##### #
# #   #     #           # #       #   # #     #   #   # #   # #     #   #   #         # # # #       #
# ### ### ### # # # ##### ### ### ##### ####### ##### # ##### # ####### # ########### # # # #########
#     # # #   # # # #     # # # #     #     #         #     # #           # #   #       #     #   # #
##### # ##### ### # ### ### # # ### ####### ####### # ####### # # ####### # # # # # # ### ### ### # #
#   #     #     # #   #     # #     #   # #     #   #       # # #     #   #   # # # # #     #     # #
# # # ##### # # ### ### ##### ### ### ### # # ########### ####### # ### ##### ##### ### # # # ### # #
# # # # # # # # #     #     # # # # #   # # #   #     #       #   # #             # # # # # # #     #
# ##### # ##### ##### # ##### # ### # # # ### ####### # ### ##### ##### ####### # ### # # ######### #
# # # #       # # #   #           #   # # #     #   #   #       #   # # # # #   #   #   # #       # #
# # # # ##### # # ### ### ##### ### ### # ##### # # # # # # # ####### # # # # # # ######### ####### #
# #     # #       #     # #     #   # #       #   #   # # # #   #   #     # # # # # #     #     #   #
# ##### # # ##### ##### ### ####### # ### # ### ##### ####### ### ######### # # # # ### # # ####### #
#       # #   #   #             # #     # # #       # #     # # #           # # #   #   #     #     #
# # # # # # ### # # ##### ####### ### ### ### ### ### # # ### # # ### ######### ### # ### ####### ###
# # # # #     # # # #         # #       # #     #   # # #   #       #     #       # #   # #         #
# ### ### ### ####### # # # # # ### ##### # # # # ### # ### # ####### ##### ######### # # ### ### ###
#   # #   #   #   #   # # # #         #     # # # #   # #       # #     # # # #       # #     # #   #
# ############### # ########### ####### ### ######### ### ####### # # # # # # ##### ######### # # ###
# #   #     # # #     #   #           #   # # #   #   # # # #     # # #   #   #     # #   #     #   #
# # # # ##### # # # ### ### # # # ########### ### # # # # # # # ########### # # ### # # # # # #######
#   # # # # # #   #   #     # # #   #     #   #     #   # # # # #         # #     # #   #   #       #
# ##### # # # # ############# # # ### ### # # ############# # ### ####### # ####### # ########### ###
#   #     #     #   # #   #   # #     #     #   # # #   #           #       #     # # #     #       #
# ### ########### ### ### ### ### # ############# # ### ####### ### ##### ### ### # ### # ####### # #
# # #   # #           # #   #   # #   #   #   # #     #   # #   # # #   #   #   #     # #   # # # # #
### ### # # # ### ### # # ####### ##### ##### # ### # ### # ### # # # ### ##### ####### ### # # # # #
#         # #   # #       # #   #   # #         #   # #   # #     #     # #     # #   # #   #     # #
### ##### ### ### ### ### # # ### ### # ### ####### ### ### # ####### ####### # # # ##### ### # ### #
#       # #     # #   #   #         #   #   #                     # #   #   # #     #   # # # # # # #
# ### ########### ####### ### ### # # # ##### ### # ### ### # ### # # # ### ### ##### # # # # # # # #
#   # #       #     #   #     #   # # # #     #   # # #   # #   # #   #   # #       # # # #   # # # #
##### ### ######### # # ### ### ##### ### ######### # # ### ##### # ####### # # ####### # ### ### # #
#   #               # #   #   #   #       #         # #   # # # # #   # #     #   #               # #
# ### # ### ### ######### ##### # # ######### # ### # ### ### # # ### # ######### # ####### ### ### #
#     #   #   # # #   #   # #   # # #   #   # #   #   # #     # #   #       #     #     #   #   # # #
# # # # ##### # # # # # ### ### # ##### ### # ### # # # # # # # ######### # ### ### ### ### # # # ###
# # # #   #   # #   #           #         #     # # #   # # #     #       # #     # #     # # #      
#####################################################################################################